41
41
11111111111111111111011111111111111111111
10001000100000000010000000101000000000101
10101110111111101010111110101011111110101
10100000100000001010000010100010001000001
10111111101111111011111010111110101010111
10101000101000101010000010100000100010001
10101010101010101010111110101111111111101
10100010001010000010000000101000001000101
10111011111011111011101111101011101010101
10000010000010001000100000100010001010101
11111110111010101010111110101110111011101
10100000001000101010001000100010001010001
10101111101111101011101011111011101010111
10001000101000001010100010000010001000101
10111010101011101010111110111110111111101
10100010101010100010000000000010100010001
10101110101010101111111111101010111010111
10001000101010001111111110101010001010001
10111011101011101111111110101010101011101
10101010001000101111111110001010100010001
10101011111110101111111111101010101110101
10001010001000101111111110101010101000101
10111010101011101111111110101010111011111
10100010100010101111011110001010000010001
10101010111110111111011111111011111110101
10101010000000100010000010000000100000101
10101010111111111010111010111110101111101
10101000100000000010001000100010101010001
11101111101111111011111111101110101010111
10001000001000001000001000001000100010001
10111110111111101111101010111011111011101
10000000100000100000101010000010001010001
11101111111010111110101110101110101010111
10101000000010001000100000100000100010101
10101011101110101011111111111111111110101
10101010001000100000000000001010001000001
10101110111110111111111111101010101111101
10100010101000100010000000001000100000001
10111010101011111010111111111111111111101
10000000100000000010000000000000000000001
11111111111111111111111111111111111111111
0 20
23 20